####################
#@....M............#
#.........#####....#
#..T...............#
#.............M....#
#....P.............#
#............T....S#
####################