####################
#@................S#
#....######........#
#..M...............#
#.........T........#
#.....P............#
#........M.....T...#
####################