####################
#@..M.............S#
#..######..........#
#...........T......#
#......P...........#
#....M.............#
#..............T...#
####################