####################
#@...T............S#
#........M.........#
#..####............#
#..................#
#......P...........#
#..M..........T....#
####################