####################
#@....M.......T...S#
#..................#
#..######..........#
#.......P..........#
#............M.....#
#........T.........#
####################