####################
#@....M......T....S#
#..................#
#....####..........#
#..............M...#
#..........P.......#
#.....T............#
####################